{
  "schema_version": 1,
  "iterations": 30,
  "warmup_iterations": 6,
  "binaries": [
    {
      "label": "stage30",
      "path": "/private/tmp/kakehashi-stage30-query-plan-973c7fba5"
    },
    {
      "label": "stage29",
      "path": "/private/tmp/kakehashi-stage29-final-ea6d5303b"
    }
  ],
  "runs": [
    {
      "binary_label": "stage30",
      "binary_path": "/private/tmp/kakehashi-stage30-query-plan-973c7fba5",
      "scenario": "rust_sparse_below_gate/typing_delta",
      "samples_ns": [
        4435625,
        4420417,
        4458000,
        4509916,
        4483708,
        4442292,
        4445459,
        4504625,
        4394292,
        4434334,
        4457917,
        4446375,
        4424500,
        4522834,
        4566250,
        4545875,
        4419500,
        4455542,
        4474875,
        4414375,
        4443042,
        4373916,
        4405875,
        4527959,
        4474584,
        4447791,
        4459750,
        4444083,
        4444208,
        4420083
      ]
    },
    {
      "binary_label": "stage29",
      "binary_path": "/private/tmp/kakehashi-stage29-final-ea6d5303b",
      "scenario": "rust_sparse_below_gate/typing_delta",
      "samples_ns": [
        4685542,
        4744667,
        4732291,
        4741083,
        4696708,
        4500167,
        4508875,
        4578500,
        4664916,
        4511083,
        4682709,
        4522459,
        4505542,
        4506500,
        4505500,
        4440042,
        4680209,
        4811250,
        4984375,
        4496458,
        4540000,
        4516250,
        4548209,
        4615958,
        4519667,
        4525084,
        4483584,
        4522292,
        4430625,
        4516166
      ]
    },
    {
      "binary_label": "stage30",
      "binary_path": "/private/tmp/kakehashi-stage30-query-plan-973c7fba5",
      "scenario": "rust_sparse_at_gate/typing_delta",
      "samples_ns": [
        4375875,
        4769708,
        4616625,
        4434167,
        4358666,
        4354417,
        4386458,
        4431458,
        4357291,
        4388583,
        4364333,
        4386458,
        4412167,
        4396875,
        4358292,
        4572958,
        4333000,
        4439291,
        4426167,
        8996833,
        5318417,
        4866834,
        5287125,
        4907167,
        5027375,
        5259375,
        5304250,
        4850708,
        4846709,
        5292959
      ]
    },
    {
      "binary_label": "stage29",
      "binary_path": "/private/tmp/kakehashi-stage29-final-ea6d5303b",
      "scenario": "rust_sparse_at_gate/typing_delta",
      "samples_ns": [
        4978416,
        5069459,
        4553375,
        5022333,
        4496708,
        4525333,
        4584333,
        4830375,
        4812459,
        4813167,
        4702416,
        4475167,
        4527084,
        4778959,
        4905542,
        5084084,
        4914959,
        5099250,
        5245583,
        4967958,
        5278166,
        5076875,
        5016750,
        4874458,
        4999666,
        5272250,
        5261916,
        5000583,
        5141792,
        5053666
      ]
    },
    {
      "binary_label": "stage30",
      "binary_path": "/private/tmp/kakehashi-stage30-query-plan-973c7fba5",
      "scenario": "rust_sparse_above_gate/typing_delta",
      "samples_ns": [
        4447208,
        4515208,
        4476875,
        4454709,
        4531500,
        4510083,
        4428417,
        4428167,
        4472458,
        4460708,
        4507125,
        4589375,
        4423959,
        4428250,
        4434834,
        4469959,
        4459291,
        4448250,
        4487833,
        4595250,
        4426167,
        4455333,
        4479459,
        4416291,
        4484709,
        4450916,
        4365792,
        4983791,
        4934209,
        4935875
      ]
    },
    {
      "binary_label": "stage29",
      "binary_path": "/private/tmp/kakehashi-stage29-final-ea6d5303b",
      "scenario": "rust_sparse_above_gate/typing_delta",
      "samples_ns": [
        4217333,
        4188208,
        4301708,
        4176583,
        4190250,
        4177750,
        4209000,
        4459250,
        4323500,
        4218000,
        4159375,
        4205042,
        4189916,
        4178417,
        4186833,
        4180667,
        4237917,
        4241209,
        4199459,
        4201709,
        4221709,
        4188584,
        4282667,
        4192541,
        4494375,
        4497458,
        4495500,
        4511959,
        4554291,
        4540500
      ]
    },
    {
      "binary_label": "stage30",
      "binary_path": "/private/tmp/kakehashi-stage30-query-plan-973c7fba5",
      "scenario": "rust_sparse_medium/typing_delta",
      "samples_ns": [
        9606583,
        9554375,
        9665791,
        9493208,
        9458250,
        9519208,
        10464833,
        1409708,
        18918375,
        10527042,
        10551792,
        10415042,
        10210709,
        10455709,
        10087833,
        10322708,
        10113666,
        10286042,
        10294041,
        10457541,
        10365458,
        10360625,
        10046791,
        9755958,
        9191208,
        9470792,
        9031042,
        9302541,
        9068250,
        9078708
      ]
    },
    {
      "binary_label": "stage29",
      "binary_path": "/private/tmp/kakehashi-stage29-final-ea6d5303b",
      "scenario": "rust_sparse_medium/typing_delta",
      "samples_ns": [
        7942250,
        8145625,
        7827542,
        8199083,
        7902250,
        8486959,
        8102417,
        8748750,
        8852542,
        8465917,
        8370833,
        8837125,
        8314625,
        8372459,
        8781542,
        8852417,
        8628334,
        8442917,
        8370125,
        8724167,
        8361875,
        8236834,
        8403500,
        8807083,
        8831542,
        8320834,
        8502042,
        8385333,
        8834375,
        8437042
      ]
    }
  ]
}