{
  "schema_version": 1,
  "iterations": 30,
  "warmup_iterations": 6,
  "binaries": [
    {
      "label": "stage29",
      "path": "/private/tmp/kakehashi-stage29-final-ea6d5303b"
    },
    {
      "label": "stage30",
      "path": "/private/tmp/kakehashi-stage30-query-plan-973c7fba5"
    }
  ],
  "runs": [
    {
      "binary_label": "stage29",
      "binary_path": "/private/tmp/kakehashi-stage29-final-ea6d5303b",
      "scenario": "rust_sparse_below_gate/typing_delta",
      "samples_ns": [
        4444000,
        4548500,
        4593042,
        4699292,
        4495334,
        4579959,
        5047792,
        5065208,
        5148583,
        5068125,
        5248709,
        5499875,
        5047458,
        4921125,
        4968875,
        5291333,
        1167166,
        16673208,
        10263250,
        10596125,
        5974333,
        1305167,
        5550250,
        6045167,
        7184375,
        5538666,
        16823375,
        8414834,
        8659042,
        7497541
      ]
    },
    {
      "binary_label": "stage30",
      "binary_path": "/private/tmp/kakehashi-stage30-query-plan-973c7fba5",
      "scenario": "rust_sparse_below_gate/typing_delta",
      "samples_ns": [
        5237334,
        4894084,
        5022917,
        4926000,
        4816084,
        4913917,
        5097959,
        4876250,
        4852125,
        4800250,
        4816000,
        4868250,
        4794583,
        5100333,
        4975042,
        5003375,
        4938750,
        4914958,
        4885458,
        4798666,
        4941000,
        4887917,
        4822209,
        4846834,
        4879292,
        4866916,
        4878750,
        5038417,
        4887625,
        4824375
      ]
    },
    {
      "binary_label": "stage29",
      "binary_path": "/private/tmp/kakehashi-stage29-final-ea6d5303b",
      "scenario": "rust_sparse_at_gate/typing_delta",
      "samples_ns": [
        4329333,
        4143042,
        4448750,
        4477042,
        4491792,
        4462916,
        4481833,
        4469792,
        4424292,
        4459250,
        4431958,
        4464166,
        4508667,
        4450167,
        4430583,
        4430583,
        4421958,
        4479167,
        4414625,
        4417625,
        4740208,
        4446333,
        4476709,
        4420542,
        4432583,
        4442916,
        4759875,
        5353417,
        4856292,
        4537042
      ]
    },
    {
      "binary_label": "stage30",
      "binary_path": "/private/tmp/kakehashi-stage30-query-plan-973c7fba5",
      "scenario": "rust_sparse_at_gate/typing_delta",
      "samples_ns": [
        4271750,
        4150791,
        4271542,
        4401000,
        4141500,
        4095167,
        4116500,
        4129542,
        4105500,
        4114125,
        4338708,
        4128292,
        4065417,
        4192458,
        4442000,
        4515375,
        4419750,
        4323750,
        4752583,
        4402333,
        4426583,
        4384458,
        4414667,
        4404917,
        4402125,
        4414459,
        4418625,
        4359833,
        4423625,
        4391834
      ]
    },
    {
      "binary_label": "stage29",
      "binary_path": "/private/tmp/kakehashi-stage29-final-ea6d5303b",
      "scenario": "rust_sparse_above_gate/typing_delta",
      "samples_ns": [
        4849917,
        4901291,
        4874250,
        4873166,
        4431292,
        4564791,
        4728917,
        4877417,
        4680584,
        4736416,
        4732250,
        4715000,
        4606833,
        4647084,
        4888625,
        4717167,
        4873750,
        4920042,
        4570166,
        4472417,
        5046500,
        4487625,
        4840583,
        4895500,
        4849250,
        4505083,
        4654500,
        4510625,
        4571541,
        4553834
      ]
    },
    {
      "binary_label": "stage30",
      "binary_path": "/private/tmp/kakehashi-stage30-query-plan-973c7fba5",
      "scenario": "rust_sparse_above_gate/typing_delta",
      "samples_ns": [
        4443250,
        4422250,
        4434166,
        4587958,
        4536458,
        4499750,
        4498375,
        4452208,
        5107125,
        4952459,
        4855542,
        5085916,
        4869542,
        4880375,
        4923708,
        4898083,
        4870083,
        4900500,
        5028958,
        4892708,
        4913958,
        4901334,
        4894459,
        4953541,
        4914500,
        5182917,
        4888416,
        4943000,
        4967250,
        4964958
      ]
    },
    {
      "binary_label": "stage29",
      "binary_path": "/private/tmp/kakehashi-stage29-final-ea6d5303b",
      "scenario": "rust_sparse_medium/typing_delta",
      "samples_ns": [
        9029083,
        9098458,
        9195125,
        9003583,
        9141416,
        9422292,
        9828500,
        9160458,
        9323667,
        9136625,
        9133375,
        9510042,
        9259667,
        9286875,
        9280500,
        9299375,
        9289042,
        9448792,
        9292083,
        9327667,
        9249708,
        9359542,
        9270292,
        9385083,
        10254208,
        10313583,
        10260709,
        10514708,
        10409875,
        10517375
      ]
    },
    {
      "binary_label": "stage30",
      "binary_path": "/private/tmp/kakehashi-stage30-query-plan-973c7fba5",
      "scenario": "rust_sparse_medium/typing_delta",
      "samples_ns": [
        8717708,
        8494875,
        8633583,
        8415917,
        8660875,
        8482666,
        8296375,
        8531250,
        8758584,
        8849917,
        8503958,
        8499791,
        8528375,
        8775666,
        9206042,
        9710500,
        9291375,
        9476917,
        9321792,
        9327625,
        9750791,
        9633417,
        9791917,
        9781000,
        9718584,
        9746584,
        9407041,
        9816166,
        9962417,
        9718083
      ]
    }
  ]
}